
特大号垃圾箱

miji/秘籍
other/暂时未能归入门派中的高级
wiz/巫师特别出品


秘籍：

移魂大法	yihun_dafa
侠客岛太玄功	taixuan_gong
辟邪剑法	pixie_sword（不用自宫）
辟邪剑法	pixie_jian（要自宫）
葵花心法	kuihua_xinfa
金蛇锥法	jinshe_zhui
金蛇游身掌	jinshe_zhang
金蛇剑法	jinshe_jian


乱七八糟：

中平枪法	zhongpingqiang
五虎断门刀	wuhuduanmendao
五毒掌		wudu_zhang
五毒心法	wudu_xinfa
五毒神功	wudu_shengong
五毒鞭法	wudu_bian
泰山剑法	taishan_sword
嵩山剑法	songshan_sword
衡山剑法	hengshan_sword
恒山剑法	hengshan_jian
凌虚步		lingxu_bu
绝门棍		juemen_gun
金乌刀		jinwu_daofa
胡家刀法	hujia_daofa
寒星八打	hanxing_bada
鬼魅身法	guimei_shenfa
长拳		changquan


巫师出品：

铁笛魔功	xuanwu_douqi
笑傲江湖曲	xiaoaojianghu
五文爪		wuwen_zhua
薇安剑法	viviensword
唐手道		tangshoudao
神照功		shenzhao_gong
魔法风云术	mtg
销魂剑法	misssword
相思刀法	missblade
法术		magic
华光流影剑	lovesword
戏花掌		lovestrike
醉卧花阴	lovesteps
情深刀		loveblade
冰天剑法	ice_sword
寒霜刀法	frost_blade
连城剑法	doomsword
东洋刀法	dongyangdaofa
华光流影剑	doggiesword
戏花掌		doggiestrike
醉卧花阴	doggiesteps
梦云刀		doggieblade

NPC专用
虎掌		celestrike(基本拳脚、基本掌法、基本招架)
铁血十二势	tiexue_steps(基本躲闪)

风雨飘香步	fengyu_bu

断魂枪法	duanhun_qiang
浣花步法	huanhua_bu(基本躲闪)

神机刀法	shengji_blade
飞仙步法	feixian_bu

